111111111111111111111111
100000000000000000000001
101111011111111101111101
10B000010000000000000001
101111111011111111111101
100000000EBB0000L0000001
111111111101111111111101
100000000000000000000001
111111111111111111111111

WE ./textures/wall.xpm
SO ./textures/wall.xpm
EA ./textures/wall.xpm
F ./textures/floor.xpm
C ./textures/ceiling.xpm
