WE ./textures/wall.xpm
SO ./textures/wall.xpm
EA ./textures/wall.xpm
NO ./textures/wall.xpm
F ./textures/floor.xpm
C ./textures/ceiling.xpm

1111111111111111111111111111111111111111111111111111111111111
10111101000000000000001 1111111111
10B000010000000000000001
101111111011111111111101
1000S00000BB0000L0000001
111111111101111111111101
100000000000000000000001
111111111111111111111111