WE ./textures/wall.xpm
SO ./textures/wall.xpm
EA ./textures/wall.xpm
NO ./textures/web_target.xpm
F ./textures/floor.xpm
C ./textures/ceiling.xpm

 1111111111111111
10000000000000001
10B00000B00000B01
10000000000000001
1000B000B000B0001
10000000W00000001
10B0B0B0000000001
10000000000000001
100010001000000001
10000000000000001
10B00000B0000B001
10000000000000001
11111111111111111

